################################
#..P........E..##..............#
#..#..####............####..#..#
#.##....#...###..###...#....##.#
#.......#.....#..#.....#.......#
#.####..#####......#####...#...#
#.#..#........#..#........####.#
#.#..#..#.#.#.#..#.#.#.#..#..#.#
#...B#..#.#.#.#..#.#.#.#..#....#
#.#..#........#..#........#..#.#
#.####..#####......#####..####.#
#......##.....#..#.....##..#...#
#.##....#...###..###...#....##.#
#..#..####............####..#..#
#..............##..E...........#
################################