################################
#E............................E#
#.##........................##.#
#.#..........................#.#
#..............................#
#..............................#
#.#..........................#.#
#.#..........................#.#
#.#..........................#.#
#.#..........................#.#
#..............................#
#..............................#
#.#..........................#.#
#.##........................##.#
#E............................E#
################################